#######
#.#.#.#
#o o o####
#       p#
##########